[
  {
    "type": "mapgen",
    "method": "json",
    "om_terrain": "lighthouse_ground",
    "weight": 75,
    "object": {
      "fill_ter": "t_floor",
      "rows": [
        "********~./////.....~***",
        "***ddddddd/////.....~~**",
        "***ddddddd////........~*",
        "******~..///////....~~~*",
        "******~.//##+##///...~~*",
        "******~//.#7 7#///....~~",
        "*~~~...//.#7 7#///..~~~~",
        "~~.....//|||+|||///..~~~",
        "~~..////||     ||///...~",
        "~~..//|||a     y|||///.~",
        "~~..//|W      IIIb|///.~",
        "~..//||        h b||//.~",
        "~..//|v           g|//.~",
        "~..//0v        C  X0//~~",
        "~..//|vu    <  t  X|//.~",
        "~~.//0y   #####C  X0//.~",
        "~..//|##+##rrr##+##|//~~",
        "~..//||r  rr>rr  k||//~~",
        "~..///|r  rr rr  l|///.~",
        "~~.///|||  r r  |||///.~",
        "~~...///||     ||///..~~",
        "*~~...///||000||///..~~*",
        "**~~~~~~~~////~//~~~****",
        "****~~**~~~//~~~~~~*****"
      ],
      "place_vehicles": [
        { "vehicle": "boat_motor_single", "x": 4, "y": 5, "rotation": 180, "chance": 10, "status": 3 },
        { "vehicle": "canoe", "x": 5, "y": 0, "rotation": 180, "chance": 10, "status": 0 }
      ],
      "place_loot": [ { "item": "rope_30", "x": 4, "y": 1, "chance": 100 }, { "item": "rope_30", "x": 7, "y": 2, "chance": 100 } ],
      "terrain": {
        " ": "t_floor",
        "/": "t_sand",
        "~": "t_water_sh",
        "*": "t_water_dp",
        "8": "t_railroad_rubble",
        ".": "t_sand",
        "d": "t_dock",
        "|": "t_rock_wall",
        "#": "t_wall_wood",
        "<": "t_wood_stairs_up",
        ">": "t_wood_stairs_down",
        "0": "t_window_domestic",
        "+": "t_door_c"
      },
      "furniture": {
        ".": [ [ "f_boulder_medium", 2 ], [ "f_boulder_small", 1 ], [ "f_boulder_large", 3 ] ],
        "y": [ "f_indoor_plant_y", "f_indoor_plant" ],
        "h": "f_chair",
        "X": "f_sofa",
        "t": "f_table",
        "R": "f_trashcan",
        "7": "f_bench",
        "C": "f_armchair",
        "a": "f_rack_coat",
        "g": "f_floor_lamp",
        "l": "f_water_heater",
        "k": "f_water_purifier",
        "I": "f_desk",
        "r": "f_rack",
        "u": "f_stool",
        "W": "f_woodstove",
        "v": "f_workbench"
      },
      "liquids": { "l": { "liquid": "water", "amount": [ 0, 100 ] } },
      "items": {
        "7": { "item": "fishing_items", "chance": 20, "repeat": [ 2, 4 ] },
        "b": { "item": "homebooks", "chance": 20, "repeat": [ 2, 4 ] },
        "v": { "item": "home_hw", "chance": 20, "repeat": [ 2, 4 ] },
        "I": { "item": "office", "chance": 20, "repeat": [ 2, 4 ] },
        "R": { "item": "trash", "chance": 25, "repeat": [ 1, 2 ] },
        "W": { "item": "stash_wood", "chance": 25, "repeat": [ 1, 2 ] },
        "t": { "item": "livingroom", "chance": 25, "repeat": [ 1, 2 ] },
        "a": { "item": "jackets", "chance": 25, "repeat": [ 1, 2 ] },
        "r": [
          { "item": "condiments", "chance": 30, "repeat": [ 1, 2 ] },
          { "item": "groce_ingredient", "chance": 30, "repeat": [ 0, 1 ] },
          { "item": "groce_bread", "chance": 30, "repeat": [ 0, 1 ] },
          { "item": "pantry_liquids", "chance": 30, "repeat": [ 0, 1 ] },
          { "item": "dry_goods", "chance": 30, "repeat": [ 1, 2 ] },
          { "item": "preserved_food", "chance": 30, "repeat": [ 1, 2 ] }
        ]
      },
      "place_monsters": [ { "monster": "GROUP_ZOMBIE", "x": [ 1, 22 ], "y": [ 1, 22 ], "density": 0.1 } ]
    }
  },
  {
    "type": "mapgen",
    "method": "json",
    "om_terrain": "lighthouse_z1",
    "object": {
      "fill_ter": "t_floor",
      "rows": [
        "                        ",
        "                        ",
        "                        ",
        "                        ",
        "          ^^^^^         ",
        "          ^^^^^         ",
        "          ^^^^^         ",
        "         ||000||        ",
        "        ||fmsmo||       ",
        "      |||R......|||     ",
        "      |...nnnnn..y|     ",
        "     ||a...u.u....||    ",
        "     |.............|    ",
        "     0h.h...<.....C0    ",
        "     0ttt...>.....g0    ",
        "     0h.h.#####...C0    ",
        "     |....C.W.C....|    ",
        "     ||..........y||    ",
        "      |y..........|     ",
        "      |||b.XXX.b|||     ",
        "        ||b...b||       ",
        "         ||000||        ",
        "                        ",
        "                        "
      ],
      "terrain": {
        ".": "t_floor",
        "|": "t_rock_red",
        " ": "t_open_air",
        "<": "t_wood_stairs_up",
        ">": "t_wood_stairs_down",
        "0": "t_laminated_glass",
        "#": "t_wall_wood",
        "^": "t_shingle_flat_roof"
      },
      "furniture": {
        "h": "f_chair",
        "A": "f_desk",
        "y": [ "f_indoor_plant_y", "f_indoor_plant" ],
        "X": "f_sofa",
        "t": "f_table",
        "u": "f_stool",
        "s": "f_sink",
        "o": "f_oven",
        "f": "f_fridge",
        "n": "f_counter",
        "m": "f_cupboard",
        "R": "f_trashcan",
        "7": "f_bench",
        "C": "f_armchair",
        "b": "f_bookcase",
        "a": "f_rack_coat",
        "g": "f_floor_lamp",
        "W": "f_fireplace"
      },
      "items": {
        "b": { "item": "homebooks", "chance": 20, "repeat": [ 2, 4 ] },
        "o": { "item": "oven", "chance": 25, "repeat": [ 1, 2 ] },
        "f": { "item": "SUS_fridge", "chance": 70 },
        "S": { "item": "shower", "chance": 25, "repeat": [ 1, 2 ] },
        "R": { "item": "trash", "chance": 25, "repeat": [ 1, 2 ] },
        "W": { "item": "stash_wood", "chance": 25, "repeat": [ 1, 2 ] },
        "t": { "item": "livingroom", "chance": 25, "repeat": [ 1, 2 ] },
        "a": { "item": "jackets", "chance": 25, "repeat": [ 1, 2 ] },
        "m": [
          { "item": "groce_condiment", "chance": 10, "repeat": [ 1, 2 ] },
          { "item": "groce_ingredient", "chance": 30, "repeat": [ 1, 2 ] },
          { "item": "groce_bread", "chance": 20, "repeat": [ 1, 2 ] }
        ],
        "n": [
          { "item": "dishes_utility", "chance": 20, "repeat": [ 1, 2 ] },
          { "item": "kitchen_appliances", "chance": 30, "repeat": [ 1, 2 ] },
          { "item": "dishes_dining", "chance": 10, "repeat": [ 1, 2 ] }
        ]
      }
    }
  },
  {
    "type": "mapgen",
    "method": "json",
    "om_terrain": "lighthouse_z2",
    "object": {
      "fill_ter": "t_floor",
      "rows": [
        "                        ",
        "                        ",
        "                        ",
        "                        ",
        "                        ",
        "                        ",
        "                        ",
        "           QQQ          ",
        "         ||000||        ",
        "        ||tSSSy||       ",
        "       ||s.....&||      ",
        "      ||R........||     ",
        "      |######+####|     ",
        "     Q0A....>...bb0Q    ",
        "     Q0Ah...<.....0Q    ",
        "     Q0A..#####..C0Q    ",
        "      |g....W....g|     ",
        "      ||D.......D||     ",
        "       ||y..@@..||      ",
        "        ||.t@@t||       ",
        "         ||000||        ",
        "           QQQ          ",
        "                        ",
        "                        "
      ],
      "toilets": { "&": {  } },
      "terrain": {
        ".": "t_floor",
        "|": "t_rock_wall",
        " ": "t_open_air",
        "<": "t_wood_stairs_up",
        ">": "t_wood_stairs_down",
        "0": "t_laminated_glass",
        "Q": "t_open_air_rooved",
        "+": "t_door_c",
        "#": "t_wall_wood"
      },
      "furniture": {
        "A": "f_desk",
        "h": "f_chair",
        "@": "f_bed",
        "y": [ "f_indoor_plant_y", "f_indoor_plant" ],
        "t": "f_table",
        "s": "f_sink",
        "M": "f_dresser",
        "R": "f_trashcan",
        "D": "f_wardrobe",
        "C": "f_armchair",
        "b": "f_bookcase",
        "g": "f_floor_lamp",
        "W": "f_fireplace",
        "S": "f_bathtub"
      },
      "items": {
        "b": { "item": "homebooks", "chance": 20, "repeat": [ 2, 4 ] },
        "@": { "item": "bed", "chance": 30, "repeat": [ 2, 4 ] },
        "D": { "item": "allclothes", "chance": 50, "repeat": [ 2, 3 ] },
        "S": { "item": "shower", "chance": 25, "repeat": [ 1, 2 ] },
        "s": { "item": "softdrugs", "chance": 25, "repeat": [ 1, 2 ] },
        "R": { "item": "trash", "chance": 25, "repeat": [ 1, 2 ] },
        "W": { "item": "stash_wood", "chance": 25, "repeat": [ 1, 2 ] },
        "t": { "item": "bedroom", "chance": 25, "repeat": [ 1, 2 ] },
        "a": { "item": "jackets", "chance": 25, "repeat": [ 1, 2 ] }
      }
    }
  },
  {
    "type": "mapgen",
    "method": "json",
    "om_terrain": "lighthouse_z3",
    "object": {
      "fill_ter": "t_floor",
      "rows": [
        "                        ",
        "                        ",
        "                        ",
        "                        ",
        "                        ",
        "                        ",
        "                        ",
        "           QQQ          ",
        "         ||000||        ",
        "        ||.yyy.||       ",
        "       ||.......||      ",
        "      ||.........||     ",
        "      |.........u.|     ",
        "     Q0X.t..<..pp.0Q    ",
        "     Q0X.t..>..pp.0Q    ",
        "     Q0X.t.....pp.0Q    ",
        "      |...........|     ",
        "      ||......u..||     ",
        "       ||.......||      ",
        "        ||.yyy.||       ",
        "         ||000||        ",
        "           QQQ          ",
        "                        ",
        "                        "
      ],
      "terrain": {
        "Q": "t_open_air_rooved",
        ".": "t_floor",
        "|": "t_rock_red",
        " ": "t_open_air",
        "<": "t_wood_stairs_up",
        ">": "t_wood_stairs_down",
        "0": "t_laminated_glass"
      },
      "furniture": { "y": [ "f_indoor_plant_y", "f_indoor_plant" ], "p": "f_pool_table", "u": "f_stool", "X": "f_sofa", "t": "f_table" },
      "items": {
        "X": { "item": "homebooks", "chance": 20, "repeat": [ 1, 2 ] },
        "t": { "item": "livingroom", "chance": 25, "repeat": [ 1, 2 ] },
        "p": { "item": "pool_table", "chance": 25, "repeat": [ 1, 2 ] }
      }
    }
  },
  {
    "type": "mapgen",
    "method": "json",
    "om_terrain": "lighthouse_z4",
    "object": {
      "fill_ter": "t_floor",
      "rows": [
        "                        ",
        "                        ",
        "                        ",
        "                        ",
        "                        ",
        "                        ",
        "                        ",
        "           QQQ          ",
        "          ||0||         ",
        "         ||y..||        ",
        "        ||yy..y||       ",
        "       ||.......||      ",
        "       |.........|      ",
        "     QQ0.xx.>.xx.0QQ    ",
        "     QQ0.xx.<.xx.0QQ    ",
        "     QQ|.........|QQ    ",
        "       ||...MM..||      ",
        "        ||.MM.M||       ",
        "         ||.M.||        ",
        "          ||0||         ",
        "           QQQ          ",
        "           QQQ          ",
        "                        ",
        "                        "
      ],
      "terrain": {
        ".": "t_floor",
        "|": "t_rock_wall",
        " ": "t_open_air",
        "<": "t_wood_stairs_up",
        "Q": "t_open_air_rooved",
        ">": "t_wood_stairs_down",
        "x": "t_generator_broken",
        "y": "t_machinery_old",
        "#": "t_wall_wood",
        "0": "t_laminated_glass"
      },
      "furniture": { "M": [ "f_crate_c", "f_cardboard_box" ] },
      "items": {
        "M": [
          { "item": "fishing_items", "chance": 30, "repeat": [ 1, 2 ] },
          { "item": "home_hw", "chance": 30, "repeat": [ 1, 2 ] },
          { "item": "allclothes", "chance": 30, "repeat": [ 1, 2 ] },
          { "item": "textbooks", "chance": 10 },
          { "item": "literature", "chance": 20 },
          { "item": "office_paper", "chance": 30, "repeat": [ 1, 2 ] },
          { "item": "preserved_food", "chance": 30, "repeat": [ 1, 2 ] }
        ]
      }
    }
  },
  {
    "type": "mapgen",
    "method": "json",
    "om_terrain": "lighthouse_z5",
    "object": {
      "fill_ter": "t_floor",
      "rows": [
        "                        ",
        "                        ",
        "                        ",
        "                        ",
        "                        ",
        "                        ",
        "           QQQ          ",
        "         #######        ",
        "        ##|000|##       ",
        "       ##|0...0|##      ",
        "      ##|0.....0|##     ",
        "      #|0.......0|#     ",
        "      #0...yyy...0#     ",
        "     Q#0...yyy...0#Q    ",
        "     Q#0....>....+#Q    ",
        "     Q#0.........0#Q    ",
        "      #|0.......0|#     ",
        "      ##|0.....0|##     ",
        "       ##|0...0|##      ",
        "        ##|000|##       ",
        "         #######        ",
        "           QQQ          ",
        "                        ",
        "                        "
      ],
      "terrain": {
        ".": "t_floor",
        "|": "t_rock_red",
        " ": "t_open_air",
        "<": "t_wood_stairs_up",
        ">": "t_wood_stairs_down",
        "0": "t_laminated_glass",
        "y": "t_machinery_old",
        "#": "t_grate",
        "+": "t_laminated_door_glass_c",
        "Q": "t_open_air_rooved"
      }
    }
  },
  {
    "type": "mapgen",
    "method": "json",
    "om_terrain": "lighthouse_roof",
    "object": {
      "fill_ter": "t_flat_roof",
      "rows": [
        "                        ",
        "                        ",
        "                        ",
        "                        ",
        "                        ",
        "                        ",
        "           QQQ          ",
        "                        ",
        "          .....         ",
        "         .......        ",
        "        .........       ",
        "       ...........      ",
        "       ...........      ",
        "     Q ........... Q    ",
        "     Q ........... Q    ",
        "     Q ........... Q    ",
        "       ...........      ",
        "        .........       ",
        "         .......        ",
        "          .....         ",
        "                        ",
        "           QQQ          ",
        "                        ",
        "                        "
      ],
      "palettes": [ "roof_palette" ],
      "terrain": { "Q": "t_open_air_rooved" }
    }
  },
  {
    "type": "mapgen",
    "method": "json",
    "om_terrain": "lighthouse_ground",
    "//": "Razorclaw-invaded variant - creature is in damaged pantry on ground floor",
    "weight": 25,
    "object": {
      "fill_ter": "t_floor",
      "rows": [
        "********~./////.....~***",
        "***ddddddd/////.....~~**",
        "***ddddddd////........~*",
        "******~..///////....~~~*",
        "******~.//##+##///...~~*",
        "******~//.#7 7#///....~~",
        "*~~~...//.#7 7#///..~~~~",
        "~~.....//|||+|||///..~~~",
        "~~..////||     ||///...~",
        "~~..//|||a     y|||///.~",
        "~~..//|W      IIIb|///.~",
        "~..//||        h b||//.~",
        "~..//|v           g|//.~",
        "~..//0v        C  T0//~~",
        "~..//|vu    <  F  T|//.~",
        "~~.//0y   #####C  T0//.~",
        "~..//|##_##333##+##|//~~",
        "~..//||3,,33>33,,k||//~~",
        "~..///|3,,33,33,,l|///.~",
        "~~.///|||,,3,3,,|||///.~",
        "~~...///||,,,,,||///..~~",
        "*~~...///||111||///..~~*",
        "**~~~~~~~~////~//~~~****",
        "****~~**~~~//~~~~~~*****"
      ],
      "place_vehicles": [
        { "vehicle": "boat_motor_single", "x": 4, "y": 5, "rotation": 180, "chance": 10, "status": 3 },
        { "vehicle": "canoe", "x": 5, "y": 0, "rotation": 180, "chance": 10, "status": 0 }
      ],
      "place_loot": [ { "item": "rope_30", "x": 4, "y": 1, "chance": 100 }, { "item": "rope_30", "x": 7, "y": 2, "chance": 100 } ],
      "terrain": {
        " ": "t_floor",
        "/": "t_sand",
        "~": "t_water_sh",
        "*": "t_water_dp",
        ".": "t_sand",
        "d": "t_dock",
        "|": "t_rock_wall",
        "#": "t_wall_wood",
        "<": "t_wood_stairs_up",
        ">": "t_wood_stairs_down",
        "0": "t_window_domestic",
        "1": "t_curtains",
        "+": "t_door_o",
        "_": "t_door_frame",
        "3": "t_floor"
      },
      "furniture": {
        ".": [ [ "f_boulder_medium", 2 ], [ "f_boulder_small", 1 ], [ "f_boulder_large", 3 ] ],
        "y": [ "f_indoor_plant_y", "f_indoor_plant" ],
        "h": "f_chair",
        "X": "f_sofa",
        "T": "f_sofa",
        "F": "f_table_flipped",
        "7": "f_bench",
        "C": "f_armchair",
        "a": "f_rack_coat",
        "g": "f_floor_lamp",
        "l": "f_water_heater",
        "k": "f_water_purifier",
        "I": "f_desk",
        "u": "f_stool",
        "W": "f_woodstove",
        "v": "f_workbench",
        "3": [ [ "f_rubble", 50 ], [ "f_rack", 10 ], [ "f_null", 40 ] ],
        "M": "f_null"
      },
      "liquids": { "l": { "liquid": "water", "amount": [ 0, 100 ] } },
      "items": {
        "7": { "item": "fishing_items", "chance": 20, "repeat": [ 2, 4 ] },
        "b": { "item": "homebooks", "chance": 20, "repeat": [ 2, 4 ] },
        "v": { "item": "home_hw", "chance": 20, "repeat": [ 2, 4 ] },
        "I": { "item": "office", "chance": 20, "repeat": [ 2, 4 ] },
        "W": { "item": "stash_wood", "chance": 25, "repeat": [ 1, 2 ] },
        "T": { "item": "livingroom", "chance": 25, "repeat": [ 0, 1 ] },
        "F": { "item": "livingroom", "chance": 25, "repeat": [ 0, 1 ] },
        "a": { "item": "jackets", "chance": 25, "repeat": [ 1, 2 ] },
        "3": [
          { "item": "can_food", "chance": 30, "repeat": [ 0, 4 ] },
          { "item": "can_drink", "chance": 30, "repeat": [ 0, 1 ] },
          { "item": "condiments", "chance": 10, "repeat": [ 1, 2 ] },
          { "item": "groce_ingredient", "chance": 20, "repeat": [ 0, 1 ] },
          { "item": "groce_bread", "chance": 5, "repeat": [ 0, 1 ] },
          { "item": "pantry_liquids", "chance": 20, "repeat": [ 0, 1 ] },
          { "item": "dry_goods", "chance": 5, "repeat": [ 1, 2 ] },
          { "item": "preserved_food", "chance": 5, "repeat": [ 1, 2 ] }
        ],
        ",": [ { "item": "can_food", "chance": 20, "repeat": [ 1, 2 ] }, { "item": "can_drink", "chance": 20 } ]
      },
      "place_monster": [
        { "monster": "mon_razorclaw", "x": 14, "y": 17, "chance": 85 },
        { "monster": "mon_razorclaw", "x": 14, "y": 19, "chance": 45 }
      ],
      "place_item": [
        { "item": "corpse", "x": 8, "y": 10, "chance": 100 },
        { "item": "corpse", "x": 16, "y": 13, "chance": 100 },
        { "item": "corpse", "x": 11, "y": 19, "chance": 100 },
        { "item": "splinter", "x": 8, "y": 16, "chance": 100, "amount": 3 },
        { "item": "2x4", "x": 8, "y": 16, "chance": 100, "amount": 2 },
        { "item": "hinge", "x": 8, "y": 16, "chance": 100, "amount": 2 }
      ]
    }
  },
  {
    "type": "mapgen",
    "method": "json",
    "om_terrain": "lighthouse_basement",
    "//": "A nether creature decided to camp out beneath the lighthouse",
    "weight": 25,
    "object": {
      "fill_ter": "t_rock",
      "rows": [
        "********~~~~~~~~~~~~~***",
        "*******~~~~~~~~~~~~~~~**",
        "******~~~~~~~~~~~~~~~~~*",
        "******~~~~~~~~~~~~~~~~~*",
        "******~~~~~~~~~~~~~~~~~*",
        "******~~~~~~~~~~~~~~~~~~",
        "*~~~~~~~~~~~~~~~~~~~~~~~",
        "~~~~~~~~~~~~,,~~~~~~~~~*",
        "~~~~~~~~~~~,,~,,~~~~~~~~",
        "~~~~~~~~~~,~~~~~,,~,,~~~",
        "~~~~~~~~~~,~~~,,~~,~~,~~",
        "~~~~~~~~~,~~~,~~~~~,~~~~",
        "~~~~~~~~~~,,,~,~~,,~~~~~",
        "~~~~~~~~~~~~~~~,,~~,~~~~",
        "~~~~~~~~~~~~~~~,~~~,~~~~",
        "~~~~~~~~~~~~####,#T~~~~~",
        "~~~~~~~~~~~##333.#~~~~~~",
        "~~~~~~~~~~~#<....#~~~~~~",
        "~~~~~~~~~~~##3333#~~~~~~",
        "~~~~~~~~~~~~######~~~~~~",
        "~~~~~~~~~~~~~~~~~~~~~~~~",
        "*~~~~~~~~~~~~~~~~~~~~~~*",
        "**~~~~~~~~~~~~~~~~~~****",
        "****~~**~~~~~~~~~~~*****"
      ],
      "terrain": {
        "*": "t_water_cube",
        "~": "t_rock",
        ",": "t_rock_roof",
        ".": "t_rock_roof",
        "#": "t_rock_wall",
        "<": "t_stairs_up",
        "3": "t_rock_roof",
        "T": "t_rock_roof"
      },
      "furniture": {
        "3": [ [ "f_rubble", 30 ], [ "f_rack", 50 ], [ "f_null", 20 ] ],
        "T": "f_null",
        ",": [ [ "f_rubble_rock", 20 ], [ "f_cave_mushrooms", 5 ], [ "f_null", 75 ] ]
      },
      "items": {
        "3": [
          { "item": "can_food", "chance": 10, "repeat": [ 1, 3 ] },
          { "item": "can_drink", "chance": 30, "repeat": [ 1, 2 ] },
          { "item": "can_food_unsealed", "chance": 30, "repeat": [ 2, 5 ] },
          { "item": "pantry", "chance": 10, "repeat": [ 1, 2 ] }
        ]
      },
      "place_monster": [
        { "monster": "mon_thing", "x": 18, "y": 11, "chance": 100 },
        { "monster": "mon_razorclaw", "x": 11, "y": 8, "chance": 15 }
      ]
    }
  },
  {
    "type": "mapgen",
    "method": "json",
    "om_terrain": "lighthouse_basement",
    "weight": 80,
    "//": "Regular root cellar with food storage",
    "object": {
      "fill_ter": "t_rock",
      "rows": [
        "********~~~~~~~~~~~~~***",
        "*******~~~~~~~~~~~~~~~**",
        "******~~~~~~~~~~~~~~~~~*",
        "******~~~~~~~~~~~~~~~~~*",
        "******~~~~~~~~~~~~~~~~~*",
        "******~~~~~~~~~~~~~~~~~~",
        "*~~~~~~~~~~~~~~~~~~~~~~~",
        "~~~~~~~~~~~~~~~~~~~~~~~~",
        "~~~~~~~~~~~~~~~~~~~~~~~~",
        "~~~~~~~~~~~~~~~~~~~~~~~~",
        "~~~~~~~~~~~~~~~~~~~~~~~~",
        "~~~~~~~~~~~~~~~~~~~~~~~~",
        "~~~~~~~~~~~~~~~~~~~~~~~~",
        "~~~~~~~~~~~~~~~~~~~~~~~~",
        "~~~~~~~~~~~~~~~~~~~~~~~~",
        "~~~~~~~~~~~~######~~~~~~",
        "~~~~~~~~~~~##rrrr#~~~~~~",
        "~~~~~~~~~~~#<....#~~~~~~",
        "~~~~~~~~~~~##rrrr#~~~~~~",
        "~~~~~~~~~~~~######~~~~~~",
        "~~~~~~~~~~~~~~~~~~~~~~~~",
        "*~~~~~~~~~~~~~~~~~~~~~~*",
        "**~~~~~~~~~~~~~~~~~~****",
        "****~~**~~~~~~~~~~~*****"
      ],
      "terrain": { "*": "t_water_cube", "~": "t_rock", ".": "t_rock_floor", "#": "t_rock_wall", "<": "t_stairs_up", "r": "t_rock_floor" },
      "furniture": { "r": "f_rack" },
      "items": {
        "r": [
          { "item": "groce_bread", "chance": 10, "repeat": [ 1, 2 ] },
          { "item": "pantry", "chance": 30, "repeat": [ 1, 3 ] },
          { "item": "groce_dairyegg", "chance": 10, "repeat": [ 1, 2 ] },
          { "item": "pantry_liquids", "chance": 30, "repeat": [ 1, 2 ] }
        ]
      }
    }
  }
]
